礙	碍
壩	垻
辦	办
幫	帮
寶	宝
報	报
幣	币
斃	毙
錶	表
纔	才
蠶	蚕
攙	搀
讒	谗
饞	馋
纏	缠
塵	尘
襯	衬
稱	爯
遲	迟
齣	出
礎	础
處	処
辭	辞
聰	聦
叢	樷
擔	担
膽	胆
導	导
糴	籴
遞	递
點	点
澱	淀
電	电
噸	吨
奪	夺
墮	陊
爾	尔
兒	儿
礬	矾
範	笵
奮	奋
糞	粪
膚	肤
復	复
複	复
蓋	盖
趕	赶
個	个
鞏	巩
溝	沟
構	构
購	购
顧	顾
關	关
櫃	樻
號	号
鬍	胡
滬	沪
護	护
劃	划
迴	回
夥	伙
擊	击
鷄	鸡
極	极
繼	继
繭	茧
艦	舰
漿	浆
槳	桨
奬	奖
醬	酱
膠	胶
癤	疖
潔	洁
藉	借
驚	惊
舊	旧
劇	剧
據	据
懼	惧
捲	卷
開	开
剋	克
墾	垦
懇	恳
誇	夸
塊	块
虧	亏
臘	腊
蠟	蜡
纍	累
壘	垒
類	类
裏	裡
禮	礼
隷	隶
簾	帘
聯	联
糧	粮
療	疗
遼	辽
瞭	了
獵	猎
臨	临
嶺	岭
亂	乱
麼	么
黴	霉
夢	梦
麵	麺
廟	庿
滅	灭
衊	蔑
畝	亩
惱	恼
腦	脑
擬	拟
釀	酿
瘧	疟
憑	凭
啓	启
簽	签
韆	千
牽	牵
竅	窍
竊	窃
寢	寑
慶	庆
瓊	琼
鞦	秋
確	确
擾	扰
熱	热
認	訒
傘	伞
喪	丧
澀	涩
瀋	渖
聲	声
溼	湿
勢	势
獸	兽
術	术
樹	树
帥	帅
囌	蘇
雖	虽
臺	台
檯	枱
態	态
體	体
糶	粜
鐵	鉄
廳	厅
塗	涂
團	团
糰	团
窪	洼
襪	袜
網	网
穩	穏
霧	霚
繫	係
戲	戯
顯	显
縣	县
響	响
嚮	向
協	劦
脅	脇
褻	亵
釁	衅
興	兴
鬚	須
懸	悬
鏇	旋
壓	圧
鹽	塩
養	养
癢	痒
鑰	鈅
藥	薬
爺	爷
醫	医
應	応
癰	痈
擁	拥
傭	佣
踴	踊
憂	忧
優	优
籲	吁
鬱	㭗
譽	誉
淵	渊
願	愿
躍	跃
雜	杂
鑿	凿
棗	枣
竈	灶
齋	斋
氈	毡
戰	战
摺	折
癥	症
證	証
隻	只
衹	只
緻	致
衆	众
晝	昼
築	筑
莊	荘
妝	妆
裝	装
壯	壮
狀	状
總	緫
鑽	鉆
罷	罢
備	备
筆	笔
邊	边
參	参
倉	仓
產	产
嘗	甞
齒	齿
蟲	虫
芻	刍
從	从
達	达
帶	带
單	单
當	当
黨	党
斷	断
對	对
隊	队
豐	丰
岡	冈
歸	帰
龜	龟
國	国
畫	画
匯	汇
彙	汇
會	会
幾	几
夾	夹
戔	戋
監	监
薦	荐
將	将
盡	尽
儘	侭
舉	举
殻	壳
來	来
樂	楽
離	离
麗	丽
兩	两
靈	灵
婁	娄
盧	卢
虜	虏
鹵	卤
滷	卤
錄	录
慮	虑
侖	仑
羅	罗
馬	马
麥	麦
黽	黾
難	难
鳥	鸟
寧	寍
齊	齐
豈	岂
氣	气
遷	迁
僉	佥
喬	乔
親	亲
窮	穷
區	区
嗇	啬
殺	杀
審	审
師	师
壽	寿
屬	属
雙	双
肅	肃
歲	岁
孫	孙
條	条
萬	万
爲	为
韋	韦
烏	乌
無	无
獻	献
寫	写
尋	寻
亞	亜
嚴	严
厭	厌
堯	尧
業	业
義	义
藝	艺
隱	隠
猶	犹
與	与
雲	云
執	执
質	貭
專	専
羆	罴
繁	䋣
疆	畺
移	迻
癲	瘨
盥	泴
答	荅
菴	庵
闇	暗
鉋	刨
盃	杯
繃	綳
併	并
稟	禀
缽	鉢
佈	布
寀	采
採	采
綵	彩
冊	册
廁	厠
筴	策
査	查
剷	铲
嚐	甞
撐	撑
喫	吃
癡	痴
勑	敕
讎	仇
紬	綢
躕	蹰
櫥	橱
廚	厨
牀	床
鎚	錘
脣	唇
蓴	蒓
餈	糍
鶿	鹚
蔥	葱
湊	凑
獃	呆
盪	荡
擣	捣
牴	抵
鵰	雕
弔	吊
疊	叠
鱷	鰐
齶	腭
琺	珐
汎	泛
氾	泛
彷	仿
峯	峰
頫	俯
彿	佛
贑	贛
稈	秆
桿	杆
榦	幹
槓	杠
箇	個
亙	亘
夠	够
鉤	鈎
僱	雇
掛	挂
柺	拐
舘	館
槼	規
槨	椁
蠔	蚝
訶	呵
覈	核
恆	恒
鬨	哄
餱	糇
餬	糊
衚	胡
譁	嘩
燬	毁
譭	毁
煇	輝
暉	輝
勣	績
雞	鸡
跡	迹
蹟	迹
齎	賫
鑑	鉴
減	减
韁	繮
殭	僵
獎	奬
腳	脚
屆	届
傑	杰
晉	晋
逕	径
淨	净
糺	糾
鉅	巨
榘	矩
侷	局
儁	俊
雋	隽
痾	疴
釦	扣
誆	誑
崑	昆
綑	捆
淚	泪
稜	棱
釐	厘
厤	曆
蒞	莅
慄	栗
鎌	鐮
鍊	煉
樑	梁
艣	櫓
鑪	爐
崙	仑
罵	骂
傌	骂
脈	脉
犛	牦
氂	牦
冪	幂
麪	麺
鬧	閙
唸	念
孃	娘
嫋	袅
齧	啮
皰	疱
礮	炮
慼	戚
啟	啓
棊	棋
淒	凄
悽	凄
旂	旗
棄	弃
鈆	鉛
潛	潜
強	强
蹻	跷
虯	虬
鰌	鰍
麴	麯
卻	却
羣	群
鎔	熔
刪	删
姍	姗
柵	栅
羶	膻
陞	升
蝨	虱
屍	尸
諡	謚
豎	竖
藷	薯
廝	厮
蒐	搜
泝	溯
遡	溯
筍	笋
飱	飧
簑	蓑
挱	挲
歎	嘆
罈	罎
壜	罎
絛	绦
衕	同
託	托
駞	驼
輓	挽
翫	玩
餵	喂
餧	喂
蝟	猬
甕	瓮
汙	污
譆	嘻
蓆	席
廈	厦
絃	弦
閒	閑
嫺	嫻
線	线
秈	籼
饟	餉
曏	嚮
廂	厢
蠍	蝎
洩	泄
攜	携
訢	欣
倖	幸
洶	汹
兇	凶
脩	修
繡	綉
鏽	銹
敘	叙
卹	恤
璿	璇
鞾	靴
燻	熏
勳	勛
壎	塤
椏	丫
贗	贋
煙	烟
菸	烟
鼴	鼹
醃	腌
嚥	咽
巗	岩
巖	岩
豔	艳
讌	宴
颺	扬
餚	肴
齩	咬
窯	窑
曄	燁
異	异
廕	蔭
頴	穎
詠	咏
湧	涌
遊	斿
於	于
慾	欲
踰	逾
癒	愈
嶽	岳
韻	韵
災	灾
讚	贊
譟	噪
皁	皂
紮	扎
吒	咤
佔	占
蹔	暫
霑	沾
讋	懾
鍼	針
蹠	跖
梔	栀
誌	志
塚	冢
眾	衆
貲	資
眥	眦
傯	偬
騌	鬃
蹤	踪
糉	粽
爭	争
吳	吴
奐	奂
彔	录
溫	温
遙	遥
呂	吕
黃	黄
虛	虚
奧	奥
眞	真
彥	彦
兌	兑
戶	户
旣	既
絕	絶
勻	匀
袞	衮
毀	毁
別	别
內	内
丟	丢
灩	灔
淩	凌
茲	兹
荊	荆
諮	咨
揹	背
寬	寛
捱	挨
牆	墙
擺	摆
䎱	䎬
襬	䙓
憊	惫
潷	滗
籩	笾
滲	渗
慘	惨
摻	掺
驂	骖
毿	毵
瘮	瘆
磣	碜
穇	䅟
糝	糁
傖	伧
創	创
滄	沧
愴	怆
蒼	苍
搶	抢
嗆	呛
熗	炝
瑲	玱
槍	枪
戧	戗
瘡	疮
鶬	鸧
艙	舱
蹌	跄
滻	浐
薩	萨
鏟	铲
齔	龀
嚙	啮
齠	龆
齙	龅
齟	龃
齡	龄
齜	龇
齦	龈
齬	龉
齪	龊
齷	龌
齲	龋
蠱	蛊
謅	诌
㑳	㑇
鄒	邹
㥮	㤘
騶	驺
縐	绉
皺	皱
趨	趋
雛	雏
蓯	苁
縱	纵
樅	枞
慫	怂
聳	耸
澾	㳠
闥	闼
撻	挞
噠	哒
韃	鞑
滯	滞
鄲	郸
憚	惮
闡	阐
撣	掸
彈	弹
嬋	婵
禪	禅
殫	殚
癉	瘅
蟬	蝉
簞	箪
蘄	蕲
囅	冁
擋	挡
檔	档
襠	裆
鐺	铛
讜	谠
儻	傥
钂	镋
籪	簖
懟	怼
墜	坠
灃	沣
艷	艳
灧	滟
剛	刚
掆	㧏
崗	岗
綱	纲
棡	㭎
鋼	钢
鬮	阄
摑	掴
幗	帼
膕	腘
蟈	蝈
嫿	婳
擓	㧟
劊	刽
鄶	郐
儈	侩
澮	浍
薈	荟
噲	哙
獪	狯
繪	绘
燴	烩
檜	桧
膾	脍
鱠	鲙
譏	讥
嘰	叽
饑	饥
機	机
璣	玑
磯	矶
蟣	虮
郟	郏
俠	侠
陝	陕
浹	浃
挾	挟
莢	荚
峽	峡
狹	狭
愜	惬
硤	硖
鋏	铗
頰	颊
蛺	蛱
瘞	瘗
篋	箧
剗	刬
淺	浅
餞	饯
綫	线
殘	残
棧	栈
賤	贱
盞	盏
錢	钱
箋	笺
濺	溅
踐	践
濫	滥
藍	蓝
尷	尴
檻	槛
襤	褴
籃	篮
韉	鞯
蔣	蒋
鏘	锵
濜	浕
藎	荩
燼	烬
贐	赆
櫸	榉
淶	涞
萊	莱
崍	崃
徠	徕
賚	赉
睞	睐
錸	铼
灕	漓
籬	篱
儷	俪
酈	郦
邐	逦
驪	骊
鸝	鹂
釃	酾
鱺	鲡
倆	俩
啢	唡
輛	辆
滿	满
瞞	瞒
顢	颟
蟎	螨
魎	魉
懣	懑
蹣	蹒
欞	棂
僂	偻
漊	溇
蔞	蒌
摟	搂
嶁	嵝
嘍	喽
縷	缕
屢	屡
數	数
樓	楼
瘻	瘘
褸	褛
窶	窭
瞜	䁖
鏤	镂
屨	屦
螻	蝼
簍	篓
耬	耧
藪	薮
擻	擞
髏	髅
瀘	泸
壚	垆
櫨	栌
轤	轳
臚	胪
鸕	鸬
顱	颅
艫	舻
鱸	鲈
擄	掳
鹺	鹾
籙	箓
濾	滤
攄	摅
論	论
倫	伦
淪	沦
掄	抡
圇	囵
綸	纶
輪	轮
癟	瘪
蘿	萝
囉	啰
邏	逻
玀	猡
欏	椤
鑼	锣
籮	箩
馮	冯
馭	驭
闖	闯
嗎	吗
獁	犸
馱	驮
馳	驰
馴	驯
媽	妈
瑪	玛
驅	驱
駁	驳
碼	码
駝	驼
駐	驻
駔	驵
駕	驾
驛	驿
駟	驷
駛	驶
駒	驹
駘	骀
駙	驸
駑	驽
駡	骂
螞	蚂
篤	笃
駭	骇
駢	骈
驍	骁
驕	骄
驊	骅
駱	骆
騁	骋
驗	验
駿	骏
駸	骎
騎	骑
騏	骐
騍	骒
騅	骓
騙	骗
騭	骘
騖	骛
騷	骚
騫	骞
驁	骜
驀	蓦
騰	腾
騮	骝
騸	骟
驃	骠
驄	骢
騾	骡
羈	羁
驟	骤
驥	骥
驤	骧
馿	驴
嘜	唛
麩	麸
澠	渑
黿	鼋
蠅	蝇
鼉	鼍
儺	傩
灘	滩
攤	摊
癱	瘫
鳬	凫
鳩	鸠
島	岛
蔦	茑
鳶	鸢
鳴	鸣
梟	枭
鴆	鸩
鴉	鸦
鳾	䴓
鷗	鸥
鴇	鸨
窵	窎
鶯	莺
鴣	鸪
搗	捣
鶇	鸫
鴨	鸭
鴦	鸯
鴞	鸮
鴝	鸲
鴒	鸰
鴛	鸳
鴕	鸵
裊	袅
鴟	鸱
鷥	鸶
鸞	鸾
鵁	䴔
鴻	鸿
鷙	鸷
鴯	鸸
鴷	䴕
鵃	鸼
鴿	鸽
鴰	鸹
鵂	鸺
鴴	鸻
鵜	鹈
鷴	鹇
鵓	鹁
鵑	鹃
鵒	鹆
鵠	鹄
鵝	鹅
鶉	鹑
鶊	鹒
鶄	䴖
鵡	鹉
鵲	鹊
鶓	鹋
鵪	鹌
鵬	鹏
鵮	鹐
鷀	鹚
鶘	鹕
鶡	鹖
鶪	䴗
鶚	鹗
鶻	鹘
鶖	鹙
鶩	鹜
鶥	鹛
鶴	鹤
鶼	鹣
鷂	鹞
鶺	鹡
鷉	䴘
鷓	鹧
鷖	鹥
鸚	鹦
鷚	鹨
鷲	鹫
鷯	鹩
鷦	鹪
鷸	鹬
鷹	鹰
鸇	鹯
鷺	鹭
鸊	䴙
鸛	鹳
鳮	鸡
劑	剂
儕	侪
濟	济
薺	荠
擠	挤
臍	脐
蠐	蛴
躋	跻
霽	霁
鱭	鲚
齏	齑
剴	剀
凱	凯
愷	恺
闓	闿
塏	垲
榿	桤
覬	觊
磑	硙
皚	皑
鎧	铠
愾	忾
餼	饩
躚	跹
劍	剑
儉	俭
險	险
撿	捡
獫	猃
檢	检
殮	殓
斂	敛
臉	脸
襝	裣
瞼	睑
瀲	潋
蘞	蔹
僑	侨
撟	挢
蕎	荞
嶠	峤
嬌	娇
橋	桥
轎	轿
礄	硚
矯	矫
鞽	鞒
櫬	榇
藭	䓖
謳	讴
傴	伛
漚	沤
慪	怄
摳	抠
奩	奁
嘔	呕
嶇	岖
嫗	妪
樞	枢
甌	瓯
歐	欧
毆	殴
瞘	眍
軀	躯
薔	蔷
墻	墙
嬙	嫱
檣	樯
穡	穑
鎩	铩
讅	谉
嬸	婶
溮	浉
獅	狮
螄	蛳
篩	筛
儔	俦
濤	涛
禱	祷
燾	焘
疇	畴
鑄	铸
籌	筹
躊	踌
囑	嘱
矚	瞩
㩳	㧐
蕭	萧
嘯	啸
瀟	潇
簫	箫
蠨	蟏
劌	刿
噦	哕
穢	秽
蓀	荪
猻	狲
遜	逊
滌	涤
縧	绦
鰷	鲦
厲	厉
邁	迈
勵	励
癘	疠
蠆	虿
躉	趸
礪	砺
糲	粝
蠣	蛎
僞	伪
潙	沩
嬀	妫
諱	讳
偉	伟
闈	闱
違	违
葦	苇
韌	韧
幃	帏
圍	围
緯	纬
煒	炜
禕	祎
瑋	玮
韍	韨
潿	涠
韓	韩
韞	韫
韙	韪
韜	韬
鄔	邬
塢	坞
嗚	呜
鎢	钨
憮	怃
廡	庑
撫	抚
蕪	芜
嘸	呒
嫵	妩
讞	谳
瀉	泻
潯	浔
蕁	荨
撏	挦
鱘	鲟
啞	唖
惡	悪
儼	俨
釅	酽
懨	恹
厴	厣
靨	靥
饜	餍
魘	魇
黶	黡
僥	侥
澆	浇
撓	挠
蕘	荛
嶢	峣
嘵	哓
嬈	娆
繞	绕
饒	饶
燒	烧
橈	桡
曉	晓
磽	硗
鐃	铙
翹	翘
蟯	蛲
蹺	跷
鄴	邺
議	议
儀	仪
蟻	蚁
囈	呓
蕕	莸
嶼	屿
歟	欤
蕓	芸
曇	昙
靉	叆
靆	叇
墊	垫
摯	挚
贄	贽
蟄	蛰
縶	絷
湯	汤
揚	扬
場	场
暘	旸
餳	饧
煬	炀
楊	杨
腸	肠
瘍	疡
碭	砀
暢	畅
鍚	钖
殤	殇
蕩	荡
燙	烫
觴	觞
堅	坚
賢	贤
腎	肾
竪	竖
慳	悭
緊	紧
鏗	铿
鰹	鲣
勞	劳
煢	茕
塋	茔
熒	荧
榮	荣
滎	荥
犖	荦
澇	涝
嶗	崂
瑩	莹
撈	捞
嘮	唠
螢	萤
營	营
縈	萦
癆	痨
嶸	嵘
鐒	铹
耮	耢
蠑	蝾
覽	览
攬	揽
纜	缆
欖	榄
鑒	鉴
幟	帜
織	织
熾	炽
職	职
識	䛊
嶨	峃
學	学
嚳	喾
鱟	鲎
黌	黉
覺	覚
攪	撹
譯	译
澤	泽
懌	怿
擇	择
嶧	峄
繹	绎
鐸	铎
蘀	萚
釋	释
籜	箨
勁	劲
剄	刭
陘	陉
涇	泾
莖	茎
徑	径
經	经
烴	烃
輕	轻
氫	氢
脛	胫
痙	痉
羥	羟
頸	颈
巰	巯
變	变
彎	弯
孿	孪
巒	峦
孌	娈
戀	恋
欒	栾
攣	挛
灣	湾
蠻	蛮
臠	脔
灤	滦
鑾	銮
靜	静
猙	狰
掙	挣
睜	睁
箏	筝
凈	净
娛	娱
俁	俣
悞	悮
換	换
渙	涣
喚	唤
繩	䋲
祿	禄
綠	緑
慍	愠
榲	媼
熅	煴
榅	媪
薀	蕰
鰮	鰛
縕	緼
搖	摇
瑤	瑶
謠	謡
侶	侣
悅	悦
脫	脱
稅	税
說	説
滾	滚
蔉	蓘
𥕦	磙
顏	顔
吶	呐
